water tank	depósito de agua	3
foreign currency	moneda extranjera	3
deferment	aplazamiento	3
drug trafficking	narcotráfico	3
industrial park	parque industrial	3
appetite	hambre	0
battleground	campo de batalla	0
unanimity	unanimidad	3
unionized	sindicalizado	3
stationery	papel de cartas	3
worth	digno	3
divergent	divergente	3
sinking	hundimiento	2
pact	tratado	2
digit	dígito	3
get better	mejorar	0
dispense	atribuir	0
misunderstanding	equivocación	0
life span	perduración	0
construction worker	obrero de la construcción	3
gratification	complacencia	0
school	centro escolar	1
commons	parque	0
diverting	divertido	0
surrounding	rodeo	0
just about	cosa de	0
manner	guisa	0
sterile	estéril	3
undersecretary	vicesecretario	2
hide	celar	0
emergency measure	medida de seguridad	0
money supply	masa monetaria	3
spokesman	portavoz	3
mainframe	procesador	0
toll	peaje	3
supplies	retén	0
webcasting	webcast	0
house arrest	arresto domiciliario	3
herb	hierba aromática	0
residual	residuo	3
wanton	ligero	0
affiliated	afiliado	2
futures market	mercado de futuros	3
dry	secar	2
antisemitic	antisemita	3
tranquillizer	calmante	1
vulnerability	desprotección	0
perinatal	perinatal	3
energy crisis	crisis del petróleo	3
settled	saldado	0
diameter	diámetro	3
elaborated	detallado	0
sanatorium	manicomio	0
seven	siete	3
total	total	3
schilling	chelín austriaco	2
experimentation	experimento	3
mountain range	cordillera	3
denationalization	privatización	0
native land	suelo natal	0
title of nobility	título nobiliario	3
infusion	infusión	3
antidemocratic	antidemocrático	3
real-time	en tiempo real	3
adjourn	retirar	0
striving	fatiga	0
contraceptive method	anticonceptivo	1
e-money	dinero electrónico	3
lapse of time	espacio de tiempo	0
ml	mililitro	3
work	empleo	0
advocacy	propugnación	0
genitalia	órgano sexual	3
shelve	aplazar	0
rework	recomponer	0
mondial	mundial	0
inscription	ranurado	0
loosen	aflojar	3
rayon	rayón	3
cursory	frívolo	0
imprecision	imprecisión	3
travel	viaje	3
globalization	globalización	3
construe	interpretar	3
appealable	apelable	3
indignity	resentimiento	0
storage capacity	capacidad de memoria	0
preconception	prejuicio	0
curiosity	curiosidad	3
hunting rifle	escopeta de caza	2
disassembly	desmontaje	3
purchase	adquisición	0
fungi	hongo	3
jungle	jungla	3
decalogue	ley antigua	0
half life	semivida de eliminación	0
base pay	salario base	3
devote	afanar	0
consent	consentimiento	3
inconclusive	inconsecuente	0
proportionate	razonable	0
sludge	lodazal	0
marginalization	exclusión social	3
austerity	parsimonia	0
adaption	adaptación	0
corporal punishment	pena corporal	3
comprehend	captar	0
destroyed	destruido	3
persist	persistir	3
stalemate	tablas	0
connectedness	concatenación	0
medical examination	analítica	0
fixation	obsesión	0
penetration	penetración	3
township	distrito	1
sixteen	dieciséis	3
foreign relations	asuntos exteriores	3
absolve	absolver	3
currency appreciation	revalorización de divisas	0
disconnection	desconexión	3
affiliate	afiliar	3
volcano	volcán	3
meal	comida	3
luck	sino	0
rest period	reposo	3
garment	atuendo	0
line of work	empleo	0
hostel	albergue juvenil	2
new economy	nueva economía	3
crucial	determinante	0
retirement pension	jubilación	3
secretary-general	secretario general	3
laid	predispuesto	0
independence	independencia	3
turning	rodeo	0
certifier	auditor de cuentas	0
revenge	vindicar	0
venereal disease	enfermedad venérea	3
streamline	posibilitar	0
struggle	fatiga	0
knit	tejido de punto	3
chlorine	cloro	3
laborer	obrero	0
piecemeal	gradual	0
take out	sacar	0
programme	programar	0
grade	juzgar	0
enumerate	enumerar	3
insulation	aislante	3
clarity	nitidez	0
hoof	casco	0
cultural relativism	relativismo cultural	3
military education	maniobras militares	0
elevator	ascensor	3
listed	matriculado	0
decentralised	descentralizado	3
honourably	honrosamente	2
tear gas	gas pimienta	3
genesis	origen	0
emblem	símbolo	3
fanatical	hooligan	0
keyword	palabra clave	3
sex tourism	turismo sexual	3
merchant shipping	flota	0
giver	dador	0
espouse	abrazar	3
biochemical	bioquímico	3
soft drink	bebida sin alcohol	0
mini	minifalda	0
palace	palacio	3
pessimism	negatividad	0
mine	laborear	0
biomagnification	bioacumulación	3
repeat offender	reincidente	3
alibi	coartada	3
freedom of thought	libertad de pensamiento	3
self-defense	defensa propia	3
alcohol addiction	alcoholismo	0
biogas	biogás	3
object	contestar	0
military campaign	campaña bélica	0
subtotal	subtotal	1
dummy	fantoche	0
singer	cantante	3
medical	facultativo	0
devastating	devastador	3
ploughshare	reja	0
doe	gama	0
consummate	bordado	0
principle	constitutivo	0
planetary	planetario	3
reorganize	remodelar	0
probe	sonda	3
reissue	reimprimir	3
participate	intervenir	0
surety	avalista	3
itinerant	vago	0
enslave	esclavizar	3
unassisted	desnudo	0
dr.	dracma	0
bar	barra	0
harmonise	compaginar	0
humanist	humanista	3
attest	demostrar	0
misdirect	corromper	0
mortality rate	índice de mortalidad	3
nut	tuerca	0
result	resultado final	0
on-demand	a instancias de	0
construction site	obra	0
not even	tampoco	0
partition	segmentación	0
mud	fango	0
cooperation	cooperación	3
polygamous	polígamo	3
infidel	infiel	3
handful	puño	0
weak	inválido	0
ignorance	ignorancia	3
medical care	cuidados médicos	3
devour	sorber	0
recent	reciente	3
contamination	contaminación	2
news	noticia	3
motto	receta	0
excavate	desbancar	0
deregulation	desregulación	3
illicit trade	tráfico	3
expense	gasto	2
monograph	monografía	3
obscenity	indecencia	1
eyesight	ver	0
assassination	homicidio calificado	0
information center	oficina de información	0
aftermath	repercusión	0
except for	a excepción de	3
loaded	grávido	0
research centre	centro de investigación	3
core subject	asignatura	3
mobilization	movilización	3
trigger	gatillo	0
life	sobrevivencia	0
mushroom	seta	3
eastern	oriental	3
bladder	vejiga	3
school day	día lectivo	0
craft	artesanía	3
co-owner	condómino	2
gracious	gentil	3
unpopular	impopular	3
affirm	sostener	0
qualitative analysis	análisis químico	1
microbiological	microbiológico	3
itinerary	itinerario	3
call option	opción de compra	2
flooding	anegamiento	1
twenty-four	veinticuatro	3
biotech	ergonomía	0
preponderant	preponderante	3
transponder	transpondedor	3
tissue	tejido vegetal	0
experience	experiencia	3
surcharge	sobreprecio	2
exportable	exportable	3
waterworks	infraestructura hidráulica	0
descend	descender	0
monarch	soberano	0
numerical	numérico	3
adenoma	adenoma	3
suburb	arrabal	3
francophone	francófono	3
graduate student	interno	0
humble	humillar	0
fungicide	fungicida	3
quantitative	cuantitativo	3
manual labour	manualidad	0
assembling	recogida	0
just	justar	0
assigned	adscrito	0
disguise	travestir	0
cap.	capacidad eléctrica	0
reformation	reelaboración	0
victim	perjudicado	0
discussant	panelista	3
extol	decantar	0
point of view	aspecto	2
vicious cycle	círculo vicioso	3
page impression	página vista	3
explanatory	explicativo	3
spread	derramamiento	0
prison	penitenciaría	3
limited liability company	s.r.l.	0
usable	disponible	0
fusion	fusión	0
unification	fusión	0
unique	aislado	0
divert	desviar	3
desire	deseo	3
overfly	sobrevolar	3
performing	actuación	0
steps	escalinata	0
invaluable	impagable	0
pillar	columna	0
antique	antiguo	0
conciliation	acto de conciliación	2
buying power	poder de compra	3
predominance	prevalencia	0
sponge	esponja	3
flatten	aplastar	0
procedure law	derecho procesal	3
establish	establecer	3
unavoidable	inevitable	3
microwave	horno de microondas	0
contributing	contributivo	0
foe	enemigo	0
intolerant	intolerante	3
beget	parir	0
wide area network	red amplia	0
enunciate	pronunciar	0
great deal	abasto	0
yoke	yugo	3
city hall	concejo	0
manufacturing	cosido	0
preliminary agreement	preacuerdo	2
cadre	cuadro	0
misleading	insidioso	0
genocide	etnocidio	0
restate	repetir	0
melanesian	melanesio	3
meddle	inmiscuir	0
political organization	organización política	3
indecency	impertinencia	0
e-business	nueva economía	3
refiner	refinador	3
sol	sol	0
rendering	actuación	0
infidelity	infidelidad	3
indispensable	necesario	0
omen	anuncia	0
raped	violado	0
adaptability	adaptabilidad	3
geostationary orbit	órbita geoestacionaria	3
greatness	magnitud	0
gin	ginebra	0
heal	sanar	3
electoral roll	encasillado	0
patrol car	coche patrulla	3
counsel	asesorar	0
circumstantial	circunstancial	3
harmonization	armonización	3
ghettoization	exclusión social	0
understood	sobreentendido	0
pest	parásito	3
hegemony	hegemonía	3
electrical engineering	electrotecnia	2
civil aircraft	avión comercial	0
juvenile	chico	0
medication	fármaco	3
scandalous	blasfemo	0
textbook	libro de texto	3
ship	buque	3
check	comprobación	3
lose consciousness	desmayar	3
weakened	claro	0
glacier	glaciar	3
loosening	relajación	3
temporary storage	almacenamiento temporal	3
computer science	ingeniería informática	3
investment company	sociedad de inversión	3
football	soccer	0
authorities	gobierno	3
loyal	fido	0
corps	cuerpo de ejército	0
rob	asaltar	3
peruse	supervisar	0
obviate	conjurar	0
digital system	digital terrestre	0
primer	cartilla	0
repression	represión	1
minister for foreign affairs	ministro de exteriores	2
monist	monista	3
sui generis	sui géneris	3
countdown	cuenta regresiva	3
weakening	mitigación	0
security officer	vigilante de seguridad	0
step by step	gradual	0
advantage	aventaja	0
seemingly	en apariencia	3
toponymic	toponímico	3
rationality	racionalidad	3
cook	cocinero	3
boundary line	demarcación	0
tax haven	paraíso fiscal	3
decennial	décimo aniversario	0
accidentally	por accidente	0
excellence	excepcionalidad	0
speculation	especulación	3
accumulation	recolección	0
villa	villa	3
repetitive	reiterado	0
scarcity	infrecuencia	0
overseas department	región de ultramar	3
spin-off	subproducto	0
jeopardy	riesgo	0
heavy water	agua pesada	3
shared	común	2
tax code	número de identificación fiscal	3
monotheistic	monoteísta	3
disclaim	desconocer	0
unanimously	unánimemente	3
wait	expectación	0
common law	derecho consuetudinario	3
exemption	inmunidad	2
tutelary	defensor	0
machine tool	máquina herramienta	3
bloody	ensangrentar	1
illumination	alumbramiento	0
market	mercado	3
bog down	enquistar	0
hierarchically	jerárquicamente	3
vivid	brillante	0
working	funcionamiento	3
police commissioner	comisario	3
dismay	truncar	0
gas chamber	cámara de gas	3
treasury	tesorería	3
validity	validez	3
odious	infame	3
employee	oficinista	0
mobile telephone	teléfono celular	3
ignorant	naco	0
in truth	en verdad	3
armed combat	conflicto	0
behalf	fruto	0
fly	circunvolar	0
hydrochloride	clorhidrato	3
half-life	semivida de eliminación	0
privy	servicios	0
printing	impresión	0
dosage	dosis	0
enablement	habilitación	0
topic	tema	3
guarded	cauteloso	0
allowed	abierto	0
spa	balneario	3
intelligible	entendible	3
dialysis	diálisis	3
free trade	librecambio	1
chemical	químico	3
play down	desinflar	0
elephant	elefante	3
allowable	abierto	0
husbandry	cultivo	0
product	producto necesario	0
irrational	irracional	3
liberalisation	liberalización	0
max	apogeo	0
high-energy	prepotente	0
mankind	raza humana	3
data	dato	3
grow	renacer	0
stress	ansia	0
natural	propio	0
neck	cuello	0
verify	abonar	0
sf	ciencia ficción	0
refund	rendir	0
oncology	oncología	3
serving	ración	1
misapplication	depredación	0
rabbi	rabino	3
nefarious	impío	0
cold	frío	3
worship	devoción	0
declaration of independence	declaración de independencia	3
ter.	colonia	0
thumb	dedo gordo	2
consumer credit	crédito de consumo	3
artisan	artesano	3
sororate	sororato	3
lonely	repuesto	0
legal right	derecho	0
civilian	paisano	0
solubility	solubilidad	3
nation	estado	1
lunch	merienda	3
taliban	talibán	0
half	mitad	3
discuss	discutir	0
market value	precio del mercado	2
remote access	acceso remoto	3
vote of confidence	moción de confianza	3
equality	igualdad	3
name	denominación	2
drop	gota	0
synchronize	sincronizar	3
realise	concienciar	0
hydrological	hidrológico	3
entirely	a cabalidad	0
square	cuadrado	1
heating system	instalación de calefacción	3
farewell	adiós	3
naming	nombramiento	0
canvas	lienzo	2
container	recipiente	3
internee	confinado	0
inadequacy	insuficiencia	3
formula	fórmula	3
viable	practicable	0
rebuilding	reconstrucción	3
cross-cultural	pluricultural	2
carp	carpa	0
statistics	estadística	3
besides	por añadidura	0
notary	notario	3
lac	laca	0
seventy	setenta	3
derivation	derivación	0
carnival	carnaval	3
ministry	departamento ministerial	0
transition	paso	0
childhood	niñez	3
travel plan	itinerario	1
base year	año base	3
punishable	punible	3
image processing	tratamiento de imágenes	3
engineer	tecnólogo	3
phone line	línea telefónica	0
brevity	brevedad	0
ethnic cleansing	limpieza étnica	3
speaking	pronuncia	0
way	manera	1
courier	transportador	3
uninformed	ignorante	2
continuous	ininterrumpido	3
blacklist	lista negra	3
butt	tras	0
flowers	flor	2
security measures	medida de seguridad	3
fade away	borrar	0
transnational corporation	empresa internacional	2
production system	producción	0
enterprise network	red empresarial	0
posit	enclavar	0
voiced	laríngeo	0
recover	refrescar	0
preservative	conservante	3
aside	aparte de	0
acumen	tino	1
emphasis	énfasis	2
poster	afiche	3
objective	destino	0
sultanate	sultanato	3
ultimate	último	0
normal	precepto	0
donation	contribución	0
cliché	estereotipo	0
librarian	bibliotecario	3
conspicuous	obvio	0
banking system	sistema bancario	3
local resident	lugareño	3
proud	noble	0
hungry	hambriento	3
axe	machado	0
applicator	aplicador	3
precise	exacto	3
supposition	atisbo	0
new-born	neonato	3
birth rate	tasa de natalidad	3
objector	contestatario	0
impunity	impunidad	3
threefold	triple	3
equipped	condicionado	0
uppermost	supremo	0
dispute	oposición	0
value chain	cadena de valor	3
bank loan	préstamo bancario	3
carbon tax	impuesto sobre el carbono	3
shipping agent	consignatario	3
tailor	sastre	0
a.k.a.	alias	2
constitutional assembly	asamblea constituyente	3
artist	artista	3
landlord	casero	0
major power	potencia	0
finance company	sociedad de cartera	2
seam	costura	0
subsequent	subsecuente	0
slum area	barriada pobre	3
ostensible	aparente	0
veterinarian	veterinario	3
orchestrate	organizar	0
line of business	empleo	0
all-embracing	globalizante	0
comb	peine	1
oust	socavar	0
trader	trader	0
reluctantly	de mala gana	0
comet	cometa	2
evict	desalojar	3
colony	colonia	3
inexplicable	incomprensible	3
general officer	prelado	0
cancel	obliteración	0
forest conservation	conservación forestal	3
unusual	desusado	3
tuning	sintonización	0
west	ocaso	0
informed	noticioso	0
linguistic	lingüístico	3
prototype	prototipo	3
hardly	a penas	0
measles	sarampión	3
paedophilia	pedofilia	3
rotary-wing aircraft	helicóptero	1
declaration	denuncia	0
shaft	guarda	0
seedling	plántula	3
mount	monte	0
volatilization	evaporación	3
cast	proyección	0
cultivator	horticultor	0
abductee	secuestrado	3
spotlight	destacar	0
art.	reportaje	0
civic duty	responsabilidad civil	0
perpetuate	eternizar	0
vest	chaleco	3
alcoholic	alcoholizado	2
purse	bolso	0
dubious	entredicho	0
telephony	telefonía	3
disobedience	desobediencia	3
hijab	hiyab	3
waterway	canal	0
inquire	preguntar	2
media	medios de masas	0
wiring	cableado	3
epoch	época	0
homophobia	homofobia	3
sub-region	subregión	0
in vivo	in vivo	3
chloroform	cloroformo	3
obstetrical	obstétrico	0
director	director general	3
barber	barbero	0
by-product	subproducto	3
bottle	botella	3
modem	módem	3
equal opportunity	igualdad de oportunidades	3
taxa	taxón	3
colonist	colono	0
rest	reposo	0
electrification	electrificación	3
end point	terminación	0
death	expiración	0
conclude	clausurar	0
desktop	escritorio virtual	1
overthrow	trastorno	0
exploitation of prostitution	explotación sexual	0
disrupt	bloquear	3
specimen	espécimen	1
in conclusion	en definitiva	0
business enterprise	comercio	0
credentials	atestado	0
recipient	destinatario	2
unjustifiable	inadmisible	0
bravery	denuedo	0
set free	liberar	0
tsunami	tsunami	3
either	tampoco	0
nursery school	guardería	0
drainage	drenaje	3
voluntarily	voluntariamente	3
afflict	atormentar	0
veracity	veracidad	3
modus operandi	modus operandi	3
business organization	sociedad de capital	0
hand in	someter	0
perverse	gamberro	0
benzodiazepine	benzodiacepina	3
cavity	foso	0
noon	mediodía	3
displaced person	evacuado	0
refer	remitir	0
biased	arbitrario	0
welcome	bienvenido	0
assembly	ensamblaje	0
in isolation	en soledad	0
communicate	comunicar	3
poise	sangre fría	0
fall in	caer	0
disparaging	denigrante	3
sedimentation	toba	0
world war	guerra mundial	3
trivialization	banalización	3
opium	opio	3
keep away	apartar	0
smear	mancha	0
working population	población activa	3
neighbor	vecino	0
processor	procesador	3
sensitively	sensiblemente	0
impregnate	preñar	0
blessed	bendito	3
harness	montura	0
syringe	jeringa	3
lawmaking	fuero	0
habitability	habitabilidad	3
radiology	radiología	3
conflict of interest	conflicto de interés	3
racism	racismo	3
detectable	constatable	0
effective demand	demanda agregada	3
convertibility	convertibilidad	3
human relations	departamento de personal	0
armoured combat vehicle	tanque	1
antiquated	prehistórico	0
grasp	comprensión	3
pulp	pulpa	3
political arena	arena política	3
sedative	calmante	1
politico	político	0
automobile industry	industria del automóvil	3
immunity	exención	0
poor	menesteroso	0
meritorious	benemérito	0
narco	narco	3
arbitrator	amigable componedor	3
coverage	crónica	0
prudent	precavido	0
rostrum	tribuna	3
applause	aplauso	3
work stoppage	lock-out	3
levelling	nivelación	3
debris	detrito	0
upkeep	trabajos de mantenimiento	0
welfare	bienestar	3
dish	plato	3
unobstructed	despejado	0
weather conditions	condiciones atmosféricas	3
glimpse	vistazo	1
monetary system	sistema monetario	3
catastrophe	desgracia	0
anti-semitic	antisemita	3
endogenous	endógeno	3
primary school	primario	0
fat	materias grasas	2
sexual activity	sexualidad	0
humanitarianism	humanitarismo	3
difference	disonancia	0
hydrologic	hidrológico	3
point of reference	referente	0
dampen	humedecer	0
stimulus	aliciente	0
applicable	aplicativo	0
sound barrier	barrera del sonido	3
titled	titulado	0
fence	enrejado	0
colossal	milagroso	0
state television	televisión de estado	3
cerebrovascular	cerebrovascular	3
synergy	sinergia	3
negotiator	negociante	0
honourable	honroso	2
canvass	sondeo	0
manufacturing sector	industria	0
penalise	penalizar	0
hormonal	hormonal	3
darkness	sombra	0
iron curtain	telón de acero	0
transnational company	empresa internacional	3
version	interpretación	2
central nervous system	sistema nervioso central	3
dry up	agostar	0
falsify	falsificar	3
multinational	empresa internacional	3
commercial activity	actividad comercial	3
indecision	indecisión	3
hopelessness	desesperación	3
weather forecasting	predicción meteorológica	3
publisher	editorial	2
pyrolysis	pirólisis	3
telecast	transmisión de vídeo	0
car park	estacionamiento	0
skyrocket	volador	0
sealing	impermeabilización	2
specialize	especializar	3
invalidate	invalidar	3
musical instrument	instrumento musical	3
unsatisfactory	alcanzado	0
guard post	puesto de guardia	3
construction materials	material de construcción	3
herring	arenque	3
conventional	trivial	0
canoe	piragua	3
wield	esgrimir	0
implore	mendigar	0
fraudster	impostor	3
minor	muchacho	1
curtain wall	tabique	1
exigency	emergencia	0
immersion	sumergimiento	0
sect	secta	3
flag	bandera	3
town	ciudad	2
autonomous region	región autónoma	3
remain	quedar	3
subterfuge	subterfugio	3
hydrological cycle	ciclo hidrológico	3
marble	mármol	3
shark	tiburón	3
bioscience	ciencias de la vida	3
collision	choque	3
exclude	silenciar	0
needs	necesario	2
banding	cinta	0
dismissed	despedido	3
sec.	marginal	0
pogrom	pogromo	3
public utility	ente nacional	0
portray	retratar	3
tried	probado	0
countryside	campo	0
unsound	destartalado	0
universalisation	universalización	3
invasion	invasión	3
response	contesta	0
a	aceleración	1
usurper	intruso	0
field officer	oficial superior	0
preferential	preferente	3
meticulous	minucioso	3
departure	marcha	0
responsibility	responsabilidad	3
skilful	sabio	3
deterioration	exacerbación	0
geographic	geográfico	3
playing	actuación	0
cellular	celular	3
closeness	cercanía	0
unsolved	pendiente	0
paper	papel	0
kinetic	cinético	3
developer	desarrollador	3
foreign minister	ministro de exteriores	3
fuel cell	célula energética	2
advance party	vanguardia	0
user interface	interfaz de usuario	3
bypass	circunvalación	3
identification number	n.°	0
imperil	arriesgar	0
frigate	fragata	3
obstetric	obstétrico	3
capability	capacidad	2
found	constituir	0
business model	planificación empresarial	1
generation	generación	3
oppressed	oprimido	3
even-handed	ecuánime	3
undertake	atrever	0
orient	levante	0
air space	región aérea	0
run away	escapar	0
make do	amañar	0
vitiate	invalidar	0
shipment	carga	0
balance of payments	balanza de pagos	3
boldness	desvergüenza	0
belief	credulidad	0
misstatement	incorrección	2
course of study	curso	0
maths	ciencias exactas	3
teach	enseñar	3
end-of-life	terminal	0
perceptible	perceptible	3
terrible	deplorable	0
liaison	contacto	3
undergo	encontrar	0
reinforced	estabilizado	0
major	mayor	3
rooted	radicado	0
protectionist	proteccionista	3
draw together	unir	0
personal assistant	secretario particular	0
corporal	cabo segundo	0
differ	discrepar	0
noma	noma	3
jet	avión de reacción	3
observation point	registro	0
financed	subvencionado	3
health certificate	parte facultativo	0
ground water	agua de pozo	0
satellite television	televisión por satélite	3
banana	banano	3
trapped	atrapado	0
police constable	condestable	0
put off	capear	0
obstructed	atascado	0
translation	traslación	0
ecotourism	ecoturismo	3
polarized	polarizado	3
self-awareness	autoconciencia	3
vocal	vocal	0
day of remembrance	aniversario	0
production control	control de producción	3
veto power	poder de veto	3
phobia	fobia	3
nominee	aspirante	2
exert	ejercitar	0
guarding	salvaguarda	0
mountain	monte	2
couch	sofá	0
arbitration clause	cláusula compromisoria	3
pillage	saqueo	3
radioisotope	radioisótopo	3
shareholder	accionista	3
prestige	majestad	0
reoccurrence	recidiva	0
chronicle	historia	0
train station	estación de ferrocarril	3
hindrance	barrera	3
bulletin	parte	0
car bomb	coche bomba	3
humid	húmedo	0
blended	mixto	0
memorandum	memorándum	2
passer-by	pasante	0
sheik	sheikh	0
readjustment	puesta a punto	0
material balance	balance de materiales	3
stepwise	gradual	0
completion	compilación	0
sea water	agua salada	2
ambit	ámbito	0
convinced	persuadido	0
annals	anales	3
military control	invasión	0
non-compliance	desobediencia	0
indifference	apatía	3
unconstitutional	inconstitucional	3
cholera	cólera	3
express	expreso	2
necessitate	requerir	2
interminable	inacabable	0
preliminary inquiry	instrucción del sumario	3
retaliation	venganza	3
sojourn	permanencia	3
banking	operación bancaria	3
greenhouse emission	gas de efecto invernadero	0
art	producción artística	0
backtrack	retroceder	0
xxiii	veintitrés	3
probable	probable	0
guinea	pintada	0
electoral	eleccionario	0
compensatory damages	indemnización por daños y perjuicios	3
pickup	recogida	0
myriad	sinfín	3
cuff	vuelta	0
numerous	múltiple	3
oxidize	oxidar	3
denomination	denominación	1
fire extinguisher	extinguidor	3
aircraft	aeronave	3
abruptly	de un momento a otro	0
substation	subestación	3
both	ambos	0
prescription	receta médica	1
delimit	acotar	1
license	licencia	3
desired	deseado	3
offending	refractario	0
declare	definir	0
bandit	pistolero	3
twenty-fifth	veinticinco	2
step forward	adelantar	0
drunk	borracho	3
organizational chart	organigrama	3
public prosecutor	fiscal	2
cataloguing	catalogación	3
dimensional	dimensional	3
dietary	dietético	3
indefinite	indeciso	0
roofing	cobijo	0
overlook	truncar	0
operating environment	entorno operativo	3
pl	plural	0
infect	contagiar	3
deter	desencaminar	0
understand	entender	3
systematic	periódico	2
try out	catar	0
vocational school	instituto técnico	2
inclement	inclemente	1
radio frequency	radiofrecuencia	3
sexuality	sexualidad	3
behavior	proceder	0
leaning	inclinación	0
fleet	flota	3
pack	envase	3
disappointing	decepcionante	3
ecstasy	enajenación	0
awakening	sacudida	0
vanish	esfumar	3
open	reabrir	1
bioethics	bioética	3
checking	comprobación	3
discredit	desprestigiar	3
copying	copia	0
ester	ester	0
advise	asesorar	3
neutron	neutrón	3
radionuclide	radioisótopo	3
deformity	deformidad	3
alert	apercibimiento	0
put forward	nominar	0
appreciable	apreciable	2
stack	apilar	3
solar power	energía solar	0
database	database	0
regulating	regulación	3
withdraw	retirar	3
landmark	punto de referencia	0
scrupulous	juicioso	0
confiscation	confiscación	3
segregate	segregado	3
pyrotechnic	pirotécnico	3
discipline	disciplina	3
data network	red de transmisión de datos	1
environmental impact	impacto ecológico	0
governmental	gubernativo	0
exhibition	exposición	0
profitably	ventajosamente	3
unloading	descarga	0
civil aviation	aviación civil	3
couple	par	0
abetment	exhortación	0
drip irrigation	riego por goteo	3
radio interview	entrevista radiofónica	2
cognitive	cognitivo	3
tyrant	autócrata	0
gen.	género	0
drilling rig	equipo de perforación	3
immunization	inmunización	3
popular	comunero	0
motion picture	obra cinematográfica	2
diocese	diócesis	3
back	espalda	3
streaming	corriente	0
come before	preceder	0
irresistible	irresistible	3
pet	animal doméstico	0
measurements	talla	0
throw out	expulsar	0
connecting	unificación	0
monastery	cenobio	0
booklet	remiendo	0
step	medida cautelar	0
additive	aditivo	3
shine	resplandecer	0
cautious	penoso	0
conciliatory	conciliatorio	3
biennial	bienal	3
complimentary	halagador	0
assault rifle	rifle de asalto	3
incl.	comprendido	0
self-harm	autolesión	2
insecticide	insecticida	3
gramme	gramo	0
poaching	caza furtiva	3
worshipper	creyente	0
criminal offense	delito penal	3
submit	someter	0
overpower	tomar	0
occupy	ocupar	0
downloadable	descargable	3
right to health	derecho a la salud	3
blueprint	prototipo	3
anti-dumping	antidumping	3
first name	nombre de pila	3
reed	lengüeta	0
alive	vivo	2
atom	átomo	3
rejection	negativa	3
consist	consistir	3
characteristic	carácter	0
revitalizing	revitalizador	0
repulse	negativa	0
responder	respondedor	0
corrective	correctivo	3
defined	neto	0
nepotism	nepotismo	3
disseminator	divulgador	3
prevail	poder	0
cotton	algodón	3
peace	paz	3
condolence	condolencia	3
venerable	augusto	0
prosecution	procedimiento	0
generated	originado	0
suppression	sofocación	0
approving	aprobación	0
canon law	cánones	0
statesman	estadista	3
guarani	guaraní	3
indissoluble	indisoluble	3
renounce	resignar	0
conjugal	marital	3
by then	a la sazón	0
pervert	desnaturalizar	0
resistance	oposición	0
charitable organization	obra social	3
customs post	barrera aduanera	0
young	juventud	3
metallurgy	metalurgia	3
national assistance	beneficio complementario	0
commissioned officer	oficial de marina	2
swelling	quiste	0
fascicle	fascículo	3
to no avail	por demás	0
abode	vivienda	0
virtuous	virtuoso	3
come forward	adelantar	0
per capita income	ingreso per cápita	3
underscore	subrayado	0
respectful	considerado	0
insuperable	infranqueable	1
populist	populista	3
world-class	trasnacional	0
correctional institution	institución de reclusión	2
watchman	vigilante de seguridad	0
bleeding	hemorragia	3
munitions	socorro	0
abominable	deplorable	0
victor	vencedor	3
cinematographic	cinematográfico	3
high technology	tecnología de punta	3
directive	directriz	0
anthem	himno	3
small town	pedanía	0
expressed	desembozado	0
henceforth	de aquí en adelante	0
transhipment	trasbordo	3
respectively	respectivamente	3
gathered	congregado	0
commercial	spot	0
bromine	bromo	3
leu	leu rumano	0
consideration	aquilatamiento	0
widening	ensancha	1
settling	madre	0
casing	funda	0
survivor	superviviente	3
metre	metro	0
constitutive	esencial	0
forbid	prohibir	3
app	app	0
baseless accusation	denuncia calumniosa	0
addressee	receptor	0
true value	valor verdadero	1
sexual abuse	abuso sexual	3
twenty-fourth	veinticuatro	2
ask for	pedir	0
adversary	adversario	3
vs.	en contra	0
totality	total	0
chloride	cloruro	3
confiscate	incautado	2
self-criticism	autocrítica	3
train	tren de pasajeros	0
recount	narrar	3
subscription	abono	0
supremacy	hegemonía	3
progressivity	progresividad	3
domestic policy	política pública	0
closing	culminación	1
infantry	infantería	3
carrot	zanahoria	3
university library	biblioteca universitaria	3
social structure	sistema social	3
noble gas	gas noble	3
identification card	cédula de vecindad	3
commodities market	mercado de productos básicos	2
organised crime	crimen organizado	3
child prostitution	prostitución infantil	3
civil action	acción civil	3
public law	derecho público	3
waters	masa de agua	3
discard	descarte	3
established church	religión del estado	0
interrupted	interrumpido	3
encyclopedia	enciclopedia	3
bipartite	bipartito	3
violator	contraventor	0
geopolitics	geopolítica	3
produced	producido	3
circumscribed	limitado	0
agricultural	agrícola	3
street address	señas	2
swimming pool	piscina	3
kindergarten	kindergarten	0
heroism	heroísmo	3
infertile	estéril	0
attempted murder	intento de homicidio	3
prime minister	jefe de gobierno	3
launder	blanquear	3
fingerprint	impresión dactilar	3
comm.	comercio	0
cage	jaula	2
undertaking	empresa	2
privatisation	privatización	2
intergenerational	intergeneracional	3
intangible	inmaterial	3
flash flood	crecida repentina	3
tabulate	tabular	3
acknowledgment	mérito	0
populace	ciudadanía	0
spectrum	ámbito	0
playground	parque infantil	3
reformist	reformista	3
military engineer	ingeniero militar	3
interplanetary	interestelar	3
geostationary	geoestacionario	3
machismo	machismo	3
advisor	colaborador externo	0
thrust	golpe	2
tenant	inquilino	3
log	cepa	0
g	gramo	3
hyperinflation	hiperinflación	3
rely upon	descansar	0
allied	aliado	3
revolve around	centrar	0
embryo	embrionario	3
strategic	estratégico	3
short film	cortometraje	3
precisely	en extenso	0
quality	cualidad	0
endemic	enfermedad endémica	3
organized crime	crimen organizado	3
ministerial decree	decreto ministerial	3
festival	festival	3
durable	continuo	0
attach	aplicar	1
farming area	tierras de labranza	3
anaemic	anémico	3
evacuated	evacuado	3
malady	enfermedad	0
shelf	estantería	0
completed	cumplido	2
self-sustaining	autosuficiente	3
lists	liza	0
genuineness	naturalidad	0
river basin	cuenca	3
overwhelming	absorbente	0
remember	memorar	0
co-production	coproducción	3
beg	mendigar	3
lump sum	suma alzada	1
reproduction	estampa	0
referendum campaign	campaña del referéndum	3
providing	cebado	0
comfortable	hospitalario	0
outstrip	superar	0
border	margen	0
mountainous	montañoso	3
mic	micrófono	0
grounding	cualificación	0
opening hours	horario de servicio	0
detector	sensor	1
mooring	amarre	2
soar	dominar	0
on occasion	de tiempo en tiempo	0
operating theatre	quirófano	3
pronouncement	pronunciamiento	3
parenting	paternidad	3
connected	ligado	0
evacuate	cagar	0
cracking	quebrantamiento	0
delve	excavar	0
intrinsic	intrínseco	3
fervent	ferviente	3
dairy product	producto lácteo	3
ecological balance	equilibrio ecológico	3
disease	enfermedad	3
branch office	afiliada	0
crediting	acreditativo	0
set on fire	inflamar	0
ex-husband	ex esposo	3
currency unit	unidad monetaria	3
adjudicator	juez	0
add together	adicionar	0
longevity	duración de la vida	3
bedroom	dormitorio	2
utter	proferir	0
calendar month	mes	0
communism	comunismo	3
oppressor	opresor	3
jab	hurgar	0
chemical analysis	análisis químico	3
gratify	llenar	0
secondary school	escuela media	0
lucky	afortunado	0
prohibition	interdicto	0
beam	viga	0
divide up	dividir	0
perfection	perfección	3
magistrate	juez	3
federal law	ley federal	3
metabolite	metabolito	3
organ	órgano	3
geographic area	territorio	0
motherhood	maternidad	3
body part	partes del cuerpo	2
cleavage	segmentación	0
allusion	alusión	3
expel	expulsar	3
module	módulo	3
freeze	helada	0
dialog	diálogo	0
signed	firmado	3
incurable	incurable	3
ex post facto	retroactivo	3
timeliness	inmediación	0
favor	cortesía	0
arguable	cuestionado	0
study programme	escolaridad	0
destine	nombrar	0
globalisation	globalización	0
tent	tienda de campaña	3
unauthorized absence	desertor	0
bound	limitar	0
opening	abertura	0
capital gain	plusvalía	3
uncompleted	sucio	0
imbalanced	desequilibrado	3
job	empleo	3
interchangeable	intercambiable	3
lay-off	suspensión de empleo	0
admit	consentir	0
figures	cohorte	0
canopy	cobijo	0
safely	a salvo	0
cl	cc	0
public speaking	discurso	0
tuesday	martes	3
disarmament	desarme	3
coexistence	coexistencia	3
regenerative	regenerativo	3
scanner	escáner	3
traffic light	semáforo	3
inflict	propinar	0
non-professional	amateur	1
ventilation system	ventilación	0
anomaly	extrañeza	0
emirate	emirato	3
homosexual	invertido	0
transfusion	transfusión de sangre	3
replenishment	relleno	0
bull	toro	3
nuptial	nupcial	3
purification plant	planta depuradora	3
westerly	poniente	0
apprehend	detener	0
dissent	desavenencia	0
examined	examinado	0
ransom	rescate	2
generic	genérico	3
fling	proyección	0
housing development	conjunto habitacional	3
unite	unificar	1
adverse	contrario	0
unity	unidad	0
incumbent	facultativo	0
nervous system	sistema nervioso	3
privileged	privilegiado	3
covenant	concordato	0
development plan	plan de crecimiento	0
entrenchment	atrincheramiento	0
diplomat	diplomático	3
main road	calle principal	3
fierce	feroz	3
diabetes	diabetes	3
retard	tonto	0
reflection	viso	0
distribution system	red de distribución	3
drawing	rotulación	0
draconian	draconiano	3
fetal	fetal	3
intransigence	intransigencia	3
cash advance	anticipo	0
historical site	lugar histórico	3
rooms	suite	0
conference room	sala de conferencia	3
commemoration	rememoración	0
repetitious	reiterado	0
lake	lago	3
attractive	apetecible	0
war crime	crimen de guerra	3
definitive	definitivo	3
masquerade	disfraz	3
dryer	secador	3
knot	entrelazamiento	0
turbulence	turbulencia	3
nanotechnology	nanotecnología	3
intersection	intersección	3
pier	atracadero	3
anti-terrorism	contraterrorismo	2
loss	renuncia	0
like	placer	0
direct democracy	democracia directa	3
dancer	bailarín	3
heed	precaución	0
free rein	carta blanca	0
adversity	adversidad	3
office automation	ofimática	3
foreseeable	previsible	3
all important	imprescindible	0
close off	bloquear	0
recommendation	recomendación	3
ess	ese	0
nuclear	atómico	1
conflict of laws	derecho internacional privado	3
corpse	cadáver	3
natural world	fenómeno natural	0
chemical agent	agente	0
noise	ruido	3
apostolic	papal	0
slur	confundir	0
public finance	hacienda pública	3
brokering	tercería	0
prohibited	intangible	0
air traffic	circulación aérea	2
refuge	albergue	2
balance sheet	balance	3
abstinence	renunciación	0
scribing	ranurado	0
nightclub	cabaré	3
sweat	sudar	0
insufficient	desprevenido	0
general store	emporio	0
equally	parejamente	0
labour union	sindicación	3
trust company	sociedad fiduciaria	2
dataset	módem	0
chronic	enfermo crónico	0
weather	condiciones atmosféricas	3
restatement	reafirmación	0
mobile phone	teléfono celular	3
quantitative analysis	análisis cuantitativo	3
living standard	vivienda	0
synthesized	sintetizado	3
disapproval	condena	0
imperial	cesáreo	0
typesetting	composición tipográfica	3
troubling	doloroso	0
exposure	desprotección	0
function	funcionalidad	0
part-time job	empleo a tiempo parcial	3
financial situation	condición financiera	0
but	sino que	0
plague	peste	3
contempt of court	resistencia a la autoridad	3
overflow	desborde	0
editing	montaje	0
valuation	apreciación	0
count	recuento	3
compute	cálculo	3
ecosystem	biota	3
distract	entretener	0
all-encompassing	globalizante	1
frequency	frecuencia	3
monument	monumento	3
signer	firmante	0
legislative act	estatuto	0
non-existent	faltante	0
on account of	a causa de	3
handset	auditivo	0
carbohydrate	azúcar	0
sibling	hermano	0
autism	autismo	3
chromosome	cromosoma	3
immobilize	parar	0
mutual	mutuo	3
universalize	generalizar	0
percent	porcentaje	0
documentary film	documental	0
special	oferta especial	0
mental patient	neurótico	0
fodder	forraje	3
colonized	colonizado	3
national monument	monumento nacional	3
circumspection	precaución	0
arbiter	amigable componedor	1
cut-off	límite	0
carcinogenic	cancerígeno	3
portion	ración	0
pension	jubilación	3
unspeakable	indecible	3
