foreign currency	moneda extranjera	0
pacemaker	marcapasos	3
pneumatic tyre	neumático	3
dynasty	dinastía	2
woods	bosque	0
aegis	patrocinio	0
integrity	integridad moral	3
voter	votante	0
tweet	tweet	3
fall off	volar	0
human shield	escudo	0
replication	reproducción	0
nodule	nódulo	3
medicament	fármaco	3
self-incrimination	autoincriminación	0
rifle butt	culata	2
scholar	literato	0
cannery	fábrica de conservas	3
deflator	deflactor	0
heading	título	0
triumph	poder	0
diverting	divertido	0
concise	cortado	0
transmission system	sistema de transmisión	2
advance information	avance informativo	0
direct	organizar	3
depraved	gamberro	0
valiant	atrevido	0
blue	azul	0
settlement	establecimiento	3
personal identification number	número de identificación personal	3
endorse	endosar	3
public library	biblioteca de consulta	0
married man	cónyuge	0
barometer	barómetro	0
interest group	grupo de interés	0
herb	hierba aromática	3
humility	humildad	3
elaborate	explayar	3
envoy	emisario	0
political class	república	0
armed robbery	atraco a mano armada	0
classification	adscripción	0
dehumanize	deshumanizar	3
seven	siete	3
elude	capear	0
law of the jungle	ley de la selva	3
cerebral palsy	parálisis cerebral	3
unit	unidad	3
experimentation	experimento	0
m.	casado	0
negative	negativo	3
emergency plan	plan de emergencia	3
denationalization	privatización	0
asset	pro	3
type	especie	3
barbarous	inhumano	0
reign	reinado	1
antidemocratic	antidemocrático	2
dogma	dogma	3
public building	edificio público	3
adamant	diamante	0
tariff	arancel	0
finance minister	ministro de finanzas	0
flora	flora	0
word	palabra	3
mm	mm	0
central bank	banco central	0
carry on	pasar	0
brake	freno	0
tel.	número de teléfono	0
decorative	pulidor	0
loosen	aflojar	0
pollute	violar	0
household	familia	3
preserving	salvaguarda	0
organized	estructurado	0
forced labor	trabajos forzados	0
malign	malicioso	0
caution	precaución	0
validated	validado	3
cursory	frívolo	0
preferably	preferiblemente	0
autonomy	autonomía	0
imprecision	imprecisión	3
machine	máquina	0
methodology	ruta	3
economic science	economía	0
interview	entrevista	0
disappoint	decepcionar	0
preferable	preferible	0
utilise	valer	0
lab	laboratory	0
wrong	afrentar	0
at night	de noche	3
cell phone	teléfono celular	3
disassembly	desmontaje	3
extortion	extorsión	0
guerilla	guerrillero	3
austere	austero	3
haste	vehemencia	0
fertility rate	tasa de natalidad	0
preventive	barrera	3
operate	intervenir	3
order	ordenación	3
consent	consentimiento	3
innovative	innovador	3
activating	accionamiento	0
news media	cuarto poder	0
personal	privado	3
production	generación	3
tax relief	deducción fiscal	3
anti-doping	antidopaje	2
take in	ilusionar	0
versus	en contra	0
undercut	filete	0
sterilization	esterilización	0
slate	pizarra	0
commemorate	conmemorar	0
detachment	indiferencia	0
multidimensional	pluridimensional	0
constitutionalism	constitucionalismo	3
arrow	flecha	3
prohibit	prohibir	3
misinformation	desinformación	3
drug-resistant	rebelde	0
gymnasium	gimnasio	3
marital	matrimonial	0
navy	marina	0
cathedral	catedral	3
foreign trade	comercio exterior	0
decree	decreto	3
driving	conducción	0
recce	reconocimiento	0
diesel	gasóleo	3
secretary-general	secretario general	3
engrave	inscribir	0
engineer	tecnólogo	0
managerial	gerencial	2
electronic mail	mensajería electrónica	0
enlightened	partidario	0
wanted	buscado	3
disturbed	apagado	0
recite	recitar	3
industrial	industrial	3
primary	primario	3
madrassa	madraza	2
amount of money	monto	0
subcontractor	subcontratista	2
leave of absence	baja	0
guerrilla warfare	guerrilla	2
antarctic	antártico	0
clarity	nitidez	0
mortgage loan	hipoteca	0
equity market	bolsa de valores	0
service	servicio	3
listed	matriculado	0
inflate	inflar	0
genesis	origen	0
corpus delicti	cuerpo del delito	3
ups and downs	altos y bajos	0
integrally	integralmente	0
double entry	partida doble	0
national day	fiesta nacional	3
penalization	escarmiento	0
merchant shipping	flota	0
iron	marte	0
systems analyst	analista de sistemas	3
palace	palacio	3
weather forecast	predicción meteorológica	3
seem	presentar	3
responsible	juicioso	3
desist	frenar	0
chess	ajedrez	2
aggravating circumstance	circunstancia agravante	0
individualization	división	0
network operator	empresa de telefonía móvil	0
guest house	casa de huéspedes	3
limitless	inmensurable	0
translator	traductor	0
disjointed	dislocado	0
animal husbandry	zootecnia	3
secession	secesión	3
satellite network	red por satélite	1
autopsy	autopsia	3
initiator	partidario	0
potency	poderío	0
popular culture	cultura popular	2
breaking up	ruptura	0
in theory	teóricamente	1
reactor	reactor nuclear	0
hunger	hambre	2
reorganize	remodelar	0
queen	reina	0
dismantlement	desmontaje	0
precarious	vacilante	0
ending	culminación	0
undue	torticero	0
government department	agencia estatal	0
reissue	reimprimir	0
sexism	sexismo	3
lethal	letal	0
surety	avalista	0
intergovernmental	intergubernamental	3
blood relative	consanguíneo	3
septic tank	pozo séptico	3
wide	ancho	3
fluid	líquido	0
congruent	igual	0
briefer	portavoz	0
linguist	lingüista	3
universalization	universalización	0
reference	consulta	3
performing artist	artistas intérpretes o ejecutantes	0
testing	test	0
eleven	once	0
observed	observado	3
fine art	artes plásticas	3
research institute	centro de investigación	0
best	número uno	0
singer	cantante	3
accede	complacer	0
construction site	obra	0
catalogue	catálogo	0
finger	dedo de la mano	0
preserve	conserva	3
adage	máxima	0
nominal value	valor nominal	0
unfold	tender	0
excavate	desbancar	0
roller	rollo	1
kitchen	cocina	3
gamma	gamma	3
uncertainty	indecisión	0
overseas territory	territorio de ultramar	3
distinction	diferenciación	0
distribution system	red de distribución	3
typist	dactilógrafo	2
human activity	acción humana	0
intrinsic value	valor real	0
refill	carga	0
research centre	centro de investigación	0
bathroom	servicios	0
oceanography	oceanología	2
beef	vaca	0
arabization	arabización	3
erect	erigir	0
environmental impact assessment	evaluación del impacto ambiental	0
flexible	flexible	0
market share	cuota de mercado	3
special interest group	grupo de interés	2
diarrhoeal	diarreico	3
bereavement	duelo	0
transatlantic	trasatlántico	0
buprenorphine	buprenorfina	3
commerce	comercio	0
reciprocal	recíproco	0
lessee	arrendatario	3
dashboard	tablero de instrumentos	3
itinerary	itinerario	0
subjugate	serenar	0
reference point	referente	0
high official	canciller	0
provocative	provocativo	0
business activity	actividad comercial	0
elicit	enardecer	0
twinning	hermanamiento	3
pathology	enfermedad	3
mouse	ratón	3
severity	inclemencia	0
recurrent	reiterado	0
harmony	concordia	0
unharmed	ileso	0
catholic	universo	0
life form	organismos	0
kin	parentela	1
bunkering	abastecimiento de combustible	0
failing	fracaso	0
impediment	obstrucción	0
just	justar	3
supervisory	supervisor	0
harmonise	compaginar	0
pseudo-	pseudo	0
victim	perjudicado	0
political system	forma de gobierno	0
succeeding	sucesivo	0
previous	delantero	3
character	carácter	0
advancement	adelanto	3
fluidity	fluidez	0
television set	tv	0
zooplankton	zooplancton	3
troika	troika	0
forested	boscoso	3
sort out	dilucidar	0
dignity	majestad	3
production line	cadena de montaje	2
semester	semestre	0
specific	pormenor	0
augur	agorero	0
beneficial	saludable	0
stereotype	estereotipar	0
unnecessary	innecesario	2
sponge	esponja	3
usher	guiar	0
statistic	estadística	0
creative	inventivo	0
nonprofit organization	organización sin fines de lucro	0
intolerant	intolerante	3
monetization	monetización	2
ply	proporcionar	0
yoke	yugo	3
stand for	simbolizar	2
trophy	trofeo	2
empowerment	concesión	3
war of independence	guerra de independencia	3
ensure	garantir	3
done	preparado	0
noise pollution	contaminación acústica	3
waste disposal	eliminación de desechos	3
seabird	ave marina	3
consulting	consultor	0
dilemma	dilema	0
civil	cívico	3
marshall	mariscal	0
profession	empleo	3
fumes	gases de escape	3
electrical power	potencia eléctrica	0
multifunctional	plurifuncional	0
internal medicine	medicina interna	3
infidelity	infidelidad	3
hand over	entregar	0
fabric	tela	0
indispensable	necesario	0
transform	transmutar	0
clinical	clínico	0
war	guerra	3
purposely	adrede	0
fork	tenedor	0
take into account	tener en cuenta	3
vagary	capricho	2
mural	mural	0
crystal	cristalizar	0
vanguard	primera línea	0
temper	despecho	0
chemical weapons	arma química	2
liberal	progresista	0
impropriety	impertinencia	0
computing	cálculo	0
homogenous	homogéneo	3
covert	cubrimiento	0
xiii	trece	0
expertise	competencia	3
leave behind	dejar	0
floating	flotador	0
pass off	pasar	0
self-protection	defensa propia	0
solicitation	colecta	0
frame of reference	sistema de coordenadas	0
deep-seated	radicado	0
ambitious	ambicioso	2
papers	carné de identidad	0
superfluous	sobrante	0
pseudonym	pseudónimo	1
short message service	servicio de mensajes cortos	2
award	galardón	3
persecution	acose	0
cubic metre	kl	0
yacht	yate	3
exigent	acucioso	0
microfiche	microficha	0
loyal	fido	0
school teacher	maestro de escuela	0
computation	cálculo	2
nonproliferation	no proliferación	0
death camp	campo de exterminio	1
drug user	toxicómano	0
fumigant	fumigante	3
freelance	free lance	3
post-	post-	0
division	división	3
methyl	metilo	0
string	encajar	0
unreached	inalcanzable	0
bilingualism	bilingüismo	2
unfamiliar	diferente	0
reference system	sistema de coordenadas	0
airfare	tarifa aérea	2
industrial process	procedimiento industrial	0
work accident	accidente de trabajo	3
financial institution	institución financiera	2
lever	palanca	3
disqualify	descalificar	3
personnel management	administración del personal	0
slow down	ralentizar	0
single market	mercado único	0
bulldozer	bulldozer	3
repetitive	reiterado	0
maximization	maximización	0
affiliation	filiación	0
summit meeting	reunión cumbre	0
substitute	substituto	0
psychosocial	psicosocial	3
annals	anales	0
business partner	socio	0
international	organización internacional	3
badge	divisa	0
warrant of arrest	orden de captura	3
understanding	clemente	0
vice	vicio	0
deceit	impostura	0
boy	hijo varón	3
funded	subvencionado	0
exploitation	delito de explotación	3
sharpening	afilado	0
denunciation	denuncia	3
usually	por lo regular	0
navigation	náutica	0
prefer	particularizar	0
notice board	tablón de anuncios	3
bribery	acto de corrupción	0
marker	reseña	0
hierarchically	jerárquicamente	3
common market	mercado único	0
predictability	previsibilidad	3
sharpen	aguzar	0
unwarranted	torticero	0
club	club	0
validity	validez	0
downing	subversión	0
ignorant	naco	0
in truth	en verdad	3
marginalisation	exclusión social	1
edible	víveres	0
go bankrupt	quebrar	0
half-life	semivida de eliminación	0
child pornography	pornografía infantil	3
soul	alma	0
licensee	licenciatario	3
health minister	ministro de la salud	0
harmonious	armonioso	0
hard currency	divisa fuerte	3
thief	ladrón	3
crop rotation	rotación de cultivos	3
enablement	habilitación	0
weighting	peso	0
critic	crítico	0
adherent	partidario	0
refine	refinar	0
pink	rosa	0
infantile	inmaduro	0
discussion	debate	3
newspaper article	suceso	0
hold back	limitar	3
persuasion	persuasión	3
levy	impuesto	0
liberalisation	liberalización	3
dive	zambullir	0
granddaughter	nieto	3
southern	sureño	0
architectural barrier	barrera arquitectónica	3
federal state	gobierno federal	0
mag	magneto	0
filthy	inmundo	3
sex offence	agresión sexual	0
stress	ansia	3
outline	sinopsis	3
political action	actividad política	0
fluent	elocuente	0
propriety	urbanidad	0
assault rifle	rifle de asalto	3
quantifiable	cuantificable	0
sf	ciencia ficción	0
case in point	antecedente	0
cutoff	límite	0
forfeit	comiso	0
embezzlement	depredación	0
incapacity	incapacitación	0
nitrogen	nitrógeno	3
dollarization	dolarización	3
ter.	colonia	0
relegate	relegar	0
popular front	frente popular	3
maid	doméstica	0
deviant	aberrante	0
beekeeping	apicultura	2
legalise	formalizar	0
police office	central de policía	3
shatter	fragmento	0
machine-gun fire	metralla	0
brigadier	general de brigada	1
conquer	conquistar	0
religious text	obra religiosa	2
market value	precio del mercado	0
equality	igualdad	3
name	denominación	3
rendering	actuación	0
participation rate	tasa de empleo	3
revert	revertir	0
criminal association	crimen organizado	2
instability	provisionalidad	0
entirely	a cabalidad	0
patent right	derecho de patente	3
unqualified	melón	0
torch	linterna	0
manifesto	manifiesto	0
year	añada	0
naming	nombramiento	0
container	recipiente	3
air force	aeronáutica militar	0
occupational hazard	riesgo profesional	2
investigation	averiguación	3
bordering	lindante	0
booby	sula	0
pathogenic	patogénico	0
ort	restos	0
seventh	séptimo	3
parking lot	estacionamiento	0
commons	parque	0
inevitable	inevitable	0
care	importar	0
advance	mejoramiento	3
natural resources	recurso natural	3
granule	gránulo	0
place	disponer	3
frequent	frecuente	0
dwelling	vivienda	0
remuneration	salario	1
question	interrogante	3
body weight	peso corporal	3
cassava	mandioca	3
breeding ground	plantel	0
law	decreto	3
breed	variedad	0
indicate	señalar	3
cooling	climatización	0
seeker	buscador	0
white	albura	0
uninformed	ignorante	0
asymmetric	asimétrico	0
shipowner	armador	3
stratospheric	estratosférico	3
disequilibrium	descompensación	0
fade away	borrar	0
brand name	marca	0
political economy	economía	0
poisoning	intoxicación	3
oath	jura	3
gathering	tropa	0
san	manicomio	0
news story	suceso	0
generalization	principio de derecho	0
duty-bound	precisado	0
vicious cycle	círculo vicioso	3
interior	parte interior	0
green	verde	0
blinding	cegador	0
impairment	daño	0
printer	impresora	0
compress	compresa	0
barrage	bombardeo	0
pair	par	0
analytically	analíticamente	3
adaptability	adaptabilidad	3
radioactive	radiactivo	0
local resident	lugareño	0
average	media	3
typeset	componer	0
ethnocentrism	etnocentrismo	2
road signs	señalización	0
shop	expendio	0
shot	disparo de bala	3
indiscipline	insumisión	0
national socialist	nazi	0
family physician	médico de familia	3
nongovernmental organization	organización no gubernamental	0
go along	acompañar	0
antiracism	antirracismo	3
wood	madera	0
awareness	conciencia	3
interstate	interestatal	0
digitize	digitalizar	3
radio transmitter	radiodifusión	0
in lieu	en cambio	0
nearly	por poco	0
dye	tintura	3
conjunction	concurso	0
revulsion	horror	0
stereoisomer	estereoisómero	3
j.	revista	0
meas.	medida	0
concern	convenir	0
emplace	disponer	0
voluntary	espontáneo	3
calendar year	año civil	0
promiscuity	promiscuidad	3
legitimacy	procedencia	0
comb	peine	0
come	venir	3
besieged	acorralado	0
residence	residencia	3
pertain	incumbir	0
dedicate	afanar	0
contract	abreviado	3
call-up	campaña	0
berry	baya	3
repulse	negativa	0
satisfaction	complacencia	3
pol	político	0
co-management	cogestión	3
rebuild	reconstruir	3
deposited	ingresado	0
linguistic	lingüístico	0
direction	noroeste	3
measles	sarampión	0
external	externo	3
psychotherapy	sicoterapia	0
attentive	cuidador	0
jute	yute	0
superintendency	supervisión	0
point source	fuente	0
tribal	tribual	0
premature	prematuro	0
trick	artificio	0
superintendence	supervisión	0
canoe	piragua	2
wholesaler	mayorista	3
green belt	área verde	0
cluster	mazo	0
good	próspero	3
protein	proteína	3
receptacle	recipiente	3
social system	sistema social	0
harsh	inclemente	0
reshape	contraer	0
vandalism	gamberrismo	0
declarant	declarante	2
even-handed	ecuánime	3
persona	papel	0
at times	cuando	0
work plan	planta	0
nest	nido	1
incarceration	detenimiento	0
driven	expeditivo	0
fruit	fruta	0
barber	barbero	0
advertisement	reclame	0
occupational safety	higiene industrial	0
immeasurably	ilimitadamente	0
substantive	sustancial	3
cruise missile	misil de crucero	3
inability	invalidez	0
go up	subir	3
actress	actriz	2
illegal work	trabajo en negro	0
civilized	civilizado	0
fateful	luctuoso	0
presumption	premisa	0
regent	veinticuatro	0
geological	geológico	0
bloc	bloque	0
as one	unánimemente	0
merchant ship	buque de transporte	0
dwelling house	vivienda	0
swim	nadar	0
war machine	aparato militar	0
listening	escucha	0
postal	postal	0
étude	estudio	3
standstill	vía muerta	0
imprisoned	prisionero	0
pole	polo	0
server	servidor	0
benefit	beneficio	3
employment office	oficina de empleo	3
fully	a cabalidad	3
family relationship	entronque	0
tower	torre	3
passionate	caldeado	0
endorsed	girado	0
veracity	veracidad	3
modus operandi	modus operandi	0
imprisonment	detenimiento	0
infant mortality rate	mortalidad infantil	0
organizing	vertebrador	0
salinization	salinización	3
mental health	salud mental	0
moon	luna	0
electric energy	energía eléctrica	0
nuclear test	prueba nuclear	0
refer	remitir	3
broker	agente de bolsa	0
world war	guerra mundial	3
throw	proyección	0
pressurize	presurizar	0
central	céntrico	0
ace	as	0
ideology	teoría política	0
apostate	apóstata	3
determinable	determinable	0
decent	decoro	0
individualize	individualizar	0
freeing	libramiento	0
psychophysical	psicofísico	2
national law	legislación nacional	0
rectification	enmienda	0
correctional	corregidor	0
involvement	involucración	3
accumulated	recolectado	0
avian flu	influenza aviar	3
convertibility	convertibilidad	3
dependable	formal	0
continental shelf	plataforma continental	0
regard	precaución	3
societal	social	3
recant	borrar	0
deutsche mark	marco alemán	0
promote	promover	0
belated	tardo	0
terminus	terminal	0
food service	catering	0
victimisation	delito de explotación	0
cooker	hornillo	0
hand tool	herramienta manual	0
inoculation	vacunación	0
popularize	popularizar	1
connect	interconectar	0
citizenship	ciudadanía	3
legal entity	persona moral	0
waste water	aguas negras	3
credibility	credibilidad	0
diarrhea	diarrea	0
graduate	diplomado	0
intercontinental	intercontinental	0
cleanup	limpieza	0
control device	dispositivo de control	0
paddy	arrozal	3
polar	polar	3
briefly	en breve	0
championship	campeonato	3
congress	congreso	3
coverage	crónica	3
take down	abajar	0
rostrum	tribuna	0
telex	teletipo	3
excretion	defecación	0
stockpile	retén	0
keep up	conservar	0
interviewer	entrevistador	3
degree course	licenciatura	3
crucial	determinante	3
dollar	dólar estadounidense	3
alerting	apercibimiento	0
telephone call	llamada	0
technological revolution	revolución tecnológica	2
reasoning	razonamiento	0
dreadful	deplorable	0
value-added tax	impuesto al valor agregado	3
tv	tv	0
depleted uranium	uranio empobrecido	3
insulate	aislar	0
physical fitness	estado de forma	0
deep-rooted	radicado	0
substantively	substantivamente	0
tranquillity	serenidad	0
fountain	chorro	0
avenge	vindicar	0
arable land	tierras arables	3
coloured	moreno	0
blockade	obstrucción	0
reordering	reestructuración	0
ceaseless	continuado	0
grandfather	abuelo	3
anal	anal	2
primary education	primera enseñanza	0
periodicity	periodicidad	0
misrepresent	desfigurar	0
residue	depósito	0
illogical	contradictorio	0
microbiology	microbiología	3
emotions	sentir	0
coroner	médico legista	0
dead end	callejón	0
undecided	inconsecuente	0
public	auditorio	3
real wage	salario real	3
compilation	redacción	0
beacon	faro	3
round-trip	viaje de regreso	0
nuclear warhead	cabeza nuclear	3
medico	doctor	0
misinterpret	malinterpretar	3
experience	experiencia	3
mental retardation	retraso mental	3
social	social	3
imaging	imaginología	0
suddenly	de un momento a otro	0
haemoglobin	hemoglobina	0
inorganic	inorgánico	0
select	escoger	3
superimpose	superponer	0
warship	buque de guerra	3
flat	mesa	0
regrettable	censurable	0
writing system	escritura	0
cruise ship	buque de cruceros	0
living together	cohabitación	0
keeping	tenencia	0
offender	contraventor	0
subterfuge	subterfugio	3
learn	aprender	3
fall apart	fragmentar	0
campsite	camping	0
archipelago	archipiélago	3
publicise	publicitar	1
biography	biografía	3
unemployment benefit	seguro de desempleo	0
comfort	tren de vida	0
sec.	marginal	0
public opinion	voz pública	0
pogrom	pogromo	3
rude	descortés	3
bumper	parachoques	0
variant	variante	0
ethics	moral	0
twenty-nine	veintinueve	2
market forces	fuerzas del mercado	3
rationalize	sincerar	0
overnight	pernoctación	0
ulema	ulema	3
coal	carbón mineral	0
help	auxilio	3
reservoir	tanque	0
hierarchy	gradación	0
soot	negro de humo	0
kinetic	cinético	3
animist	animista	3
food chain	cadena alimenticia	2
resort	recurrir	0
detected	detectado	3
university student	universitario	0
reappearance	reaparición	3
reciprocally	recíprocamente	0
milestone	hito	2
sweeping	desecho	0
bigger	mayor	0
designation	designación	0
bone marrow	médula	0
by hand	manualmente	0
inequality	disparidad	3
soya	soya	0
inherent	integrador	0
athletics	atletismo	2
trailer	remolque	3
mental	mental	0
carbon dioxide	anhídrido carbónico	0
thirteenth	decimotercero	0
oppressed	oprimido	1
idea	fama	3
numeric	numeral	0
oil	aceite	0
shipping container	contenedor	0
conventional weapon	arma convencional	0
sympathizer	adicto	0
projected	prominente	0
hydraulic	hidráulico	0
irremovability	inmovilidad	0
ministerial	ministerial	3
paradise	tierra de promisión	0
print	tirar	0
fall ill	enfermar	3
physical rehabilitation	reeducación	0
circumstance	circunstancia	0
friday	viernes	0
dung	estiércol	0
case law	derecho anglosajón	0
menstrual	menstrual	3
difficulty	complejidad	3
heroin	heroína	0
coastline	litoral	2
reproach	reproche	0
give in	ceder terreno	0
revolutionary	turbulento	0
unresolved	irresuelto	0
end-of-life	terminal	0
wither	marchitar	0
expedient	medio	0
castle	castillo	3
reinforced	estabilizado	0
seeming	aparente	0
spiritual	espiritual	0
ammonium nitrate	nitrato de amonio	3
spiritually	espiritualmente	3
security system	sistema de seguridad	0
ironing	planchado	3
distributive	dispersivo	0
life sentence	prisión perpetua	0
higher learning	enseñanza superior	2
corporal	cabo segundo	0
pensioner	pensionado	0
guest	huésped	0
sexual relation	acceso carnal	1
divorce	divorcio	0
community property	comunidad	0
health certificate	parte facultativo	0
contra	contrariedad	0
regulation	regulado	2
omnipresent	omnipresente	0
disqualification	descalificación	3
social insurance	instituto de previsión social	0
postal service	correo	0
dispose of	matar	0
hotel	hotel	2
mentality	mentalidad	0
mishap	contratiempo	0
believe	estar	3
carnage	hecatombe	0
oscillate	vibrar	0
lament	llorar	0
dossier	legajo	0
anticipate	prever	0
instruction	enseñanza	3
recording	grabación	0
dismantling	desmontaje	0
humanitarian organization	agencia humanitaria	0
air fare	tarifa aérea	3
footnote	anotar	0
seed capital	capital inicial	3
air carrier	compañía aérea	3
smallpox	viruela	3
tarnish	exacerbación	0
cave	caverna	0
legal action	actas	0
finding	distingo	0
cold chain	cadena de frío	3
monastery	cenobio	0
inconvenience	incomodar	1
plunder	saquear	3
functional group	grupo funcional	0
mobile	teléfono celular	0
sometimes	cuando	0
dissolved	disuelto	3
hindrance	barrera	0
drying up	secado	0
negotiable instrument	título valor	0
liberate	liberar	0
come forward	adelantar	0
working hour	hora ordinaria	0
co-operative	cooperativa	0
felon	malhechor	1
management accounting	gestión contable	0
ambit	ámbito	3
stifle	rodilla	0
delinquent	caducado	0
justice	justicia	3
preliminary examination	examen preliminar	3
ruin	devastación	0
firewood	leña	3
subsection	subsección	0
factor	constituyente	0
non-compliance	desobediencia	0
electronic signature	firma digital	0
take after	salir	0
invoke	invocar	0
breast	seno	0
distraction	distracción	0
political sphere	arena política	0
resolve	resolución	3
underlying	esencial	0
x	diez	0
greenhouse emission	gas de efecto invernadero	0
patriotism	patrioterismo	0
right to strike	derecho a huelga	0
sex	sexo	3
constellation	constelación	0
nautical mile	milla náutica	3
electoral	eleccionario	3
compensatory damages	indemnización por daños y perjuicios	3
consecutive	secuencial	0
unconscious	inconsciente	3
prescribe	recetar	0
mailbox	buzón de correos	0
aircraft	aeronave	3
premise	máxima	0
genre	género	0
final payment	pago liberatorio	0
prelude	preludio	0
renminbi	yuan	0
reverse	revés	0
annual	aniversario	3
vice-presidency	vicepresidencia	1
bandit	pistolero	0
connection	interconexión	3
old age	tercera edad	0
duty bound	precisado	0
toxicology	toxicología	3
load	carga	0
simple	bobo	0
medical history	historia clínica	3
cataloguing	catalogación	1
newborn	neonato	0
eviction	desahucio	3
home worker	trabajador a domicilio	3
church	iglesia	0
shaykh	sheikh	0
expensive	costoso	0
complication	laboriosidad	0
publishing	sector editorial	0
strategy	estrategia	3
in vivo	in vivo	3
radioactive waste	residuo nuclear	0
territory	territorio	3
imam	imán	0
honorary	honorífico	3
data bank	database	0
bidding	mandamiento	0
vocational school	instituto técnico	0
stolen	robado	3
metro	metropolitano	0
judicial	contencioso	3
tolerate	pasar	0
holocaust	holocausto	0
pace	frecuencia	0
airstrike	bombardeo aéreo	0
loot	despojo	0
mining area	cuenca	0
pack	envase	0
binding	carátula	0
obstacle	barrera	3
laundering	colada	0
ineffective	inconducente	0
advise	asesorar	2
sham	imitación	0
commune	ayuntamiento	0
restraint	condicionamiento	0
yesterday	día de ayer	0
cement	cemento	0
robust	durable	0
e-mail address	e-mail	0
mini-	mini-	0
airbase	base aérea	3
royalty	familia real	0
machinery	maquinaria	0
mass media	medios de masas	0
organization	asociación	3
redistribution	redistribución	0
field study	trabajo sobre el terreno	0
arbitration court	tribunal arbitral	0
precedence	precedencia	0
superficial	simplista	1
cemetery	cementerio	0
cherish	acariciar	0
source	reencontrar	0
decontamination	descontaminación	3
remaining	residual	3
cordon	bloquear	0
format	formato	0
advocate	adicto	0
smallness	cortedad	0
extricate	soltar	0
emergence	emergencia	0
police headquarters	central de policía	3
gynaecology	ginecología	2
rotate	rodar	0
glove	guante	0
immunization	inmunización	3
unstable	vacilante	0
disorder	desorden	0
summarise	sustanciar	0
spring	primavera	0
some	cosa de	0
testator	testador	3
candle	vela	2
sermon	sermón	3
earth science	geociencia	3
seclusion	retiro	0
eating	comida	0
flogging	flagelación	0
agreement	confederación	3
greenhouse gas	gas de efecto invernadero	0
colonization	colonización	0
informatics	ciencia de la información	0
subtract	restar	0
readability	legibilidad	0
pipeline	oleoducto	0
concretely	concretamente	0
data model	modelo de datos	3
simulation	ficción	0
vote of no confidence	voto de censura	3
hatred	odio	0
consequently	por consecuencia	0
block	bloque	0
credible	plausible	0
repair	acomodación	0
computational	computacional	3
holding cell	cámara de seguridad	0
conquest	invasión	0
retailer	minorista	2
gramme	gramo	0
realisation	comprensión	0
poaching	caza furtiva	3
span	rebasar	0
lease contract	leasing	0
spam	correo basura	3
lone	único	0
creosote	creosota	2
collapsed	derrumbado	2
pastor	rector	0
remand home	penitenciaría	0
properly	decentemente	0
justice of the peace	juez de paz	3
marriage certificate	certificado de matrimonio	3
forefather	mayores	0
difference of opinion	oposición	0
revitalizing	revitalizador	0
maturity	madurez	0
interventionist	intervencionista	3
boldface	letra negrita	0
continuously	día y noche	0
insignia	insignia	3
high-speed	ultrarrápido	0
mental disease	enfermedad mental	3
celestial body	astro	0
surpassing	maravilloso	0
precept	valor moral	0
coordinator	coordinador	3
engineering	ingeniería	0
nationalism	nacionalismo	3
cotton	algodón	0
humanities	humanidades	3
aeronautical	aeronáutico	3
application	pedimento	0
telecommunication equipment	telecomunicación	0
condolence	condolencia	0
endocrine	endocrino	3
warplane	avión de guerra	0
desert	desierto	0
delineation	delineación	0
indissoluble	indisoluble	3
required	obligatorio	2
depth	profundidad	0
summit	cima	0
fresh	fresco	0
weighty	cebado	0
kilometre	km	0
pervert	desnaturalizar	0
in case	en caso de que	0
in consequence	por consecuencia	0
illegible	ininteligible	0
birthplace	cuna	0
toponymy	toponimia	2
energy industry	sector energético	2
concerned	preocupado	3
walk out	hacer huelga	0
national assistance	beneficio complementario	0
national income	renta nacional	0
brigade	brigada	0
surfactant	surfactante	3
temporary employment	trabajo temporero	2
moribund	moribundo	0
medical diagnosis	procedimiento de diagnóstico	0
ed.	editor	0
underscore	subrayado	0
chap.	capellán	0
army unit	sección	0
knife	cuchillo de cocina	1
military position	posición	0
antigen	antígeno	3
at worst	en todo caso	0
real number	número real	0
click	clic	0
reclassification	reclasificación	1
reproduce	reproducir	0
birr	nervio	0
small town	pedanía	0
henceforth	de aquí en adelante	0
mammography	mamografía	3
military law	derecho militar	3
shoreline	litoral	0
fertilization	concepción	0
gathered	congregado	0
uncollectible	fallido	0
fifteenth	quinceavo	0
separation	receso	0
tremor	temblor	3
implicit	sobreentendido	0
survivor	superviviente	0
video game	videojuego	3
caste system	casta	0
forbid	prohibir	3
clout	remendar	0
addressee	receptor	0
scandal	escándalo	3
cloud	nube	3
lime	lima	0
meeting room	sala de conferencia	2
tar	alquitrán	0
archbishop	arzobispo	3
few	poco	3
state of the art	estado de la cuestión	0
solid ground	tierra firme	0
kiosk	glorieta	0
company law	derecho de sociedades	3
disarming	desarme	0
sore	enardecido	0
transient	migrante	0
project management	control del proyecto	0
athlete	deportista	0
hydrolysis	hidrólisis	3
tag	etiqueta	0
tribalism	tribalismo	3
conformity	conformidad	3
pawn	pignorar	0
depiction	delineación	0
net profit	neto	0
bend	curva	0
university library	biblioteca universitaria	3
native	nativo	0
sir	caballero	0
syndrome	síndrome	0
arrangement	disposición	3
prognosis	pronóstico	0
sentiments	sentir	0
counterfeit	imitación	3
sin	pecado	2
typewriter	máquina de escribir	3
exculpatory	justificativo	0
farm	chacra	0
public law	derecho público	0
notebook	libreta	0
belongings	stock	0
role player	actor	0
lieutenant general	teniente general	3
supranational	supranacional	3
concentration camp	campo de concentración	3
astronomical	astronómico	2
special character	carácter especial	0
whilst	mientras que	0
press agency	agencia de prensa	3
exclusion	excepción	0
relativity	relatividad	0
acquiesce	complacer	0
restrain	limitar	3
conformance	conformidad	0
richness	riqueza	0
citrus	cítricos	3
general hospital	policlínica	3
elephant	elefante	2
bulk carrier	granelero	3
transparent	lucio	0
lower status	inferioridad	0
university	uni	0
disregard	negligencia	0
beneath	debajo de	0
denuclearized	desnuclearizado	2
illuminate	iluminar	3
climatic	climático	0
society	club	3
populace	ciudadanía	0
hazardous waste	residuos peligrosos	0
sacrifice	renuncia	0
red	rojo	0
umbrella	paraguas	0
tempo	tiempo	0
thorium	torio	3
clarify	dilucidar	3
cutting-edge	evolucionado	0
sanatorium	manicomio	0
biosphere	biosfera	3
diminished	caído	0
police surveillance	vigilancia especial	0
times	multiplicación	0
vehicular	vehicular	0
student council	claustro	0
retail	menudear	0
extraterritorial	extraterritorial	3
co-founder	cofundador	3
salient	ingente	0
publication	publicación	3
privacy	derecho a la intimidad	0
overdraft	sobregiro	2
detailing	particularización	0
body politic	estado	0
priority	superioridad	0
anaemic	anémico	0
postgraduate	interno	0
completed	cumplido	0
negro	moreno	0
simulate	simulado	0
overwhelming	absorbente	0
haven	remanso	0
remember	memorar	0
congenital	ínsito	0
bi-weekly	quincenal	3
objectionable	objetable	3
transport system	sistema de transporte	0
calamity	desgracia	0
transgression	contravención	0
reproduction	estampa	0
referendum campaign	campaña del referéndum	3
providing	cebado	0
anthropologist	antropólogo	3
ingenious	fantasioso	0
plastic explosive	explosivo plástico	3
poverty-stricken	descalzo	0
fail	fracaso	3
apparently	en apariencia	0
competency	competencia	0
depict	retratar	0
court case	contencioso	0
rout	derrota	0
water level	nivel	0
incentive	incentivo	0
repercussion	eco	0
sequel	continuación	0
safety factor	factor de seguridad	0
look at	ver	3
moveable	transportable	0
pressure group	grupo de presión	3
over and above	además de	0
placement	acomodo	0
undeniably	indiscutiblemente	0
peacekeeper	pacificador	0
unsettle	aguar	0
reprehensible	censurable	3
stove	cocina	2
homeowner	casero	0
bedroom	dormitorio	3
neurotoxic	neurotóxico	0
debate	argumentación	0
decade	década	3
litigation	contencioso	0
leaching	lixiviación	3
envy	envidia	3
communism	comunismo	3
pointed	apuntado	0
cube	cubo	0
solar wind	viento solar	3
housing problem	problema de alojamiento	0
federal law	ley federal	0
ghetto	gueto	3
ordain	dar órdenes	0
embryonic	embrionario	3
widow	viuda	0
intervening	interpuesto	0
conform	uniformar	0
frame	armazón	0
freeze	helada	0
co-director	codirector	2
wire	cable eléctrico	3
customs and traditions	usos y costumbres	3
nightmare	pesadilla	3
dlr	dólar	0
correctly	legalmente	0
pistol	pistola	0
contagious disease	enfermedad transmisible	2
super-	super-	0
sewerage	aguas negras	3
admin	gestión	0
antisocial	antisocial	3
fester	supurar	0
leishmaniasis	leishmaniosis	0
coexistence	coexistencia	0
urban sprawl	aglomeración urbana	1
building management	dirección de las obras	0
cover up	encubrir	0
regenerative	regenerativo	3
scanner	escáner	3
discrimination	discrimen	0
sports centre	polideportivo	2
shaikh	sheikh	0
plastic bag	bolsa de plástico	1
ventilation system	ventilación	0
utilizing	delito de explotación	0
criminal court	tribunal penal	0
controller	controlador	0
accident	azar	0
axle	eje	0
cargo aircraft	avión de carga	3
infestation	infestación	3
painter	pintor	3
crude oil	petróleo crudo	3
welcoming	bienvenido	0
speculator	especulador	3
territorial division	subdivisión administrativa	0
ultra	extremista	0
westerly	poniente	2
bring about	traer	0
sustenance	subsistencia	2
time limit	término	0
risk factor	factor de riesgo	0
strange	ajeno	0
knowledge acquisition	adquisición de conocimiento	0
geographical	geográfico	3
underground	subterráneo	0
call off	anular	0
unimaginable	impensable	1
ball	pelota	2
exchange rate risk	riesgo de cambio	0
diploma	diploma	0
main road	calle principal	3
whale	ballena	1
recommendatory	recomendatorio	3
well	pozo	3
unceasingly	día y noche	0
reference manual	manual de referencia	0
command	mandamiento	0
reside	residir	3
increasingly	cada vez mas	0
replenish	saciar	0
chat room	sala de chat	0
interim	ínterin	3
distant	remoto	0
interdepartmental	interministerial	0
purified	purificado	0
cage	jaula	0
demographic	demográfico	0
semipublic	semipúblico	3
concourse	palca	0
morgue	morgue	3
tour operator	turoperador	0
war crime	crimen de guerra	0
chancellor	canciller	0
dryer	secador	1
knot	entrelazamiento	0
sex life	sexualidad	0
tick	garrapata	0
garage	garage	3
imprison	arrestar	0
virginity	virginidad	3
rule out	desestimar	0
searching	busca	0
ventilated	ventilado	2
regularized	regularizado	0
gymnastics	cultura física	0
promulgate	pregonar	0
public policy	política pública	0
lean	inclinación	0
overlap	entrecruzar	0
e-mail	mensajería electrónica	0
observer	argos	3
southerner	meridional	0
inaccurate	inexacto	3
brokering	tercería	0
prohibited	intangible	0
in view of	en orden a	3
sister	hermana	0
linger	eternizar	0
anchorage	anclaje	0
shipping	acarreo	0
dominion	colonia	0
emperor	emperador	3
own	disponer	2
poverty level	umbral de la pobreza	0
labour union	sindicación	3
assess	tomar en cuenta	3
chronic	enfermo crónico	0
doubtless	seguro	0
van	camioneta	0
elastic	elástico	3
decision maker	administrador	0
invisibility	invisibilidad	3
typesetting	composición tipográfica	2
cliff	acantilado	0
vat	pila	0
naturally	de suyo	0
funnel	embudo	0
cosmopolitan	cosmopolita	3
revalue	revalorizar	0
storehouse	repositorio	0
oil spill	derrame de petróleo	3
construction	edificación	3
valuation	apreciación	0
embargo	embargo	2
signed	firmado	0
monastic	monje	0
regression analysis	análisis de regresión	3
dissemination	derramamiento	0
pig	puerco	0
sibling	hermano	0
replica	estampa	3
disengagement	desconexión	0
proceeds	rendimiento	0
balcony	balcón	3
building site	solar	0
boot	bota	2
non-resident	externo	0
mental patient	neurótico	0
fodder	forraje	3
waste management	gestión de residuos	0
national monument	monumento nacional	3
stay	ubicar	0
animosity	inquina	1
veil	velar	0
developing nation	país subdesarrollado	0
auxiliary	auxiliar	0
compete	rivalizar	0
anomaly	extrañeza	0
go off	hacer fuego	0
buoy	baliza	0
